R 1924 1080
NO /Users/kgale/Desktop/mycub/textures/bluestone .xpm
SO /Users/kgale/Desktop/mycub/textures/eagle.xpm


EA /Users/kgale/Desktop/mycub/textures/wood.xpm

S /Users/kgale/Desktop/mycub/textures/pillar.xpm




F 255,255,0
WE /Users/kgale/Desktop/mycub/textures/redbrick.xpm
C 101,67,33

      11111111111
    110000000000011
   10000000000000001
  1000000000000000001
 100000000000000000001
10000000000000000000001
100000000000000000000001
100000000000000000000001
100000000000000000000001
100000000000000000000001                                        1111111111
1000000000000000000000001                                      100000000001
1000000000000000000000001111111111111111111111111111111111111110000000000001
10000000000000000000000000000000000000000000000000000000000000000000000000001
 10000000000000000000000000000000000000000000000000000000000000000000000000001
 100000000000000000000000000000000000000000000000000000000000000000000000000001
 100000000000000000000000000000000000000000000000000000000000000000000000000001
  10000000000000000000000000000000000000000000000000000000000000000000000000001
  10000000000000000000000000000000000000000000000000000000000000000000000000001
   100000000000000000000000000000000000000000000000000000000000000000000000001
    100000000000000000000000000000W0000000000000000000000000000000000001111112222 2
   100000000000000000000000000000000000000000000000000000000000000000000000001     2 2
  10000000000000000000000000000000000000000000000000000000000000000000000000001       2
  10000000000000000000000000000000000000000000000000000000000000000000000000001     2   2
 100000000000000000000000000000000000000000000000000000000000000000000000000001          2
 100000000000000000000000000000000000000000000000000000000000000000000000000001       2
 10000000000000000000000000000000000000000000000000000000000000000000000000001            2
10000000000000000000000000000000000000000000000000000000000000000000000000001        2
1000000000000000000000000111111111111111111111111111111111111110000000000001               2
1000000000000000000000001                                      100000000001
100000000000000000000001                                        1111111111           2     2
100000000000000000000001
100000000000000000000001                                                             2     2
100000000000000000000001
 1000000000000000000001
  10000000000000000001                                                              2222  2
   100000000000000001                                                             22222222222
    1100000000000011                                                            22222222222222
      111111111111                                                                 22222222
